R 100000 100000
NO ./textures/1.xpm
SO ./textures/2.xpm
WE ./textures/3.xpm
EA ./textures/4.xpm

S  ./textures/5.xpm
F  51,51,255
C  45,52,54

        1111111111111111111111111
        1200000000110000000000021
        1011000001110040000005001
        1001000000000000000000001
111111111011000001110000000000001
100000000011000001110111111311111
11110111111111011100000010001
11110111111111011101010010001
11000000110101011100000010001
10002000000000001100000010001
10000000000000001101010010001
11000001110101011111011110N0111
11112111 1112101 101111010001
11111111 1111111 111111111111
