R 1600 900
NO ./textures/1.xpm
SO ./textures/2.xpm
WE ./textures/3.xpm
EA ./textures/4.xpm

S  ./textures/5.xpm
F  45, 52, 54
C  45, 52, 54

        1111111111111111111111111
        1200005000110000000000021
        1011000001110040000005001
        1001000000000000000000001
111111111011000001110000000000001
100000000011000001110111111310111
111101111111110111000000100010001
111101       10111010100100010001
110001111111110111000000100010001
104020000000000011000000100010001
100000000000000011010100100010001
11110001110101011111011110N010001
1  12111 1112101    1011110100011
11111111 1111111    1111111111111
