R 1600 900
NO ./textures/1.xpm
SO ./textures/2.xpm
WE ./textures/3.xpm
EA ./textures/4.xpm

S  ./textures/5.xpm
F  11,22,533
C  666,689,65

1111111111111111111111111
1000000000110000000000001
1011000001110004002005001
1001000000000000000000001
1111111110110000011100001
1000000000110000011101111
11110111111111011100000011111
11110111111111011101010030001
11000000110101011100000010001
10002000000000001100000010001
10000000000000001101010010001
11000001110101011111011010001
1111N111 1110101 101111010061
11111111 1111111 111111111111
