R 1600 900
NO ./textures/1.xpm
SO ./textures/2.xpm
WE ./textures/3.xpm
EA ./textures/4.xpm

S  ./textures/5.xpm
F  555,555,555
C  665,654,456

11111111111111111111111111111111111111111
10000000000000000000000000000000000000001
10000400000000000000000000000000000000001
10000000000000000000000000000004000000001
10000000000000000000000000000000000000001
10000000000000000000000000000000000000001
10000000000000000400000000000000000000001
10000000000000000000000000000000000000001
10005000000000050000E00000000000000000001
10000000000000000000000000000000000000001
10000000000000000000000000000000000000001
10000000000002000000000000000000000000001
10000000000000000000000000000000000000001
10000000000000000000000000005000000000001
10000050000000000000000000000000000000001
10000000000000000000050000000000000000001
10000000000000000000000000000000000000021
11111111111111111111111111111111111111111
